gene_short_name	direction
BTG2	Overlap: Fischer up_HSPC MUT down
CYFIP2	Overlap: Fischer up_HSPC MUT down
TRIM22	Overlap: Fischer up_HSPC MUT down
YPEL3	Overlap: Fischer up_HSPC MUT down
DGKZ	Overlap: Fischer up_HSPC MUT down
IRF5	Overlap: Fischer up_HSPC MUT down
ANXA1	Overlap: Fischer up_HSPC MUT down
DUSP1	Overlap: Fischer up_HSPC MUT down
RARRES3	Overlap: Fischer up_HSPC MUT down
PYCARD	Overlap: Fischer up_HSPC MUT down
PTGS2	Overlap: Fischer down_HSPC MUT up
RGCC	Overlap: Fischer down_HSPC MUT up
LONP1	Overlap: Fischer down_HSPC MUT up
ODC1	Overlap: Fischer down_HSPC MUT up
SOD2	Overlap: Fischer down_HSPC MUT up
DNMT1	Overlap: Fischer down_HSPC MUT up
MDM2	Overlap: Fischer up_HSPC MUT up
GADD45A	Overlap: Fischer up_HSPC MUT up
PLK3	Overlap: Fischer up_HSPC MUT up
TRIAP1	Overlap: Fischer up_HSPC MUT up
AEN	Overlap: Fischer up_HSPC MUT up
SESN1	Overlap: Fischer up_HSPC MUT up
TP53INP1	Overlap: Fischer up_HSPC MUT up
ATF3	Overlap: Fischer up_HSPC MUT up
PRKAB1	Overlap: Fischer up_HSPC MUT up
PTP4A1	Overlap: Fischer up_HSPC MUT up
IER5	Overlap: Fischer up_HSPC MUT up
PMAIP1	Overlap: Fischer up_HSPC MUT up
DHRS3	Overlap: Fischer up_HSPC MUT up
BTG3	Overlap: Fischer up_HSPC MUT up
BID	Overlap: Fischer up_HSPC MUT up
HTT	Overlap: Fischer up_HSPC MUT up
IRF2BP2	Overlap: Fischer up_HSPC MUT up
MAP4K4	Overlap: Fischer up_HSPC MUT up
DUSP2	Overlap: Fischer up_HSPC MUT up
FDPS	Overlap: Fischer up_HSPC MUT up
IRF9	Overlap: Fischer up_HSPC MUT up
LDLR	Overlap: Fischer up_HSPC MUT up
SIAH1	Overlap: Fischer up_HSPC MUT up
SUB1	Overlap: Fischer up_HSPC MUT up
ULK1	Overlap: Fischer up_HSPC MUT up
CERS6	Overlap: Fischer up_HSPC MUT up
HSPA8	Overlap: Fischer down_HSPC MUT down
ME3	Overlap: Fischer down_HSPC MUT down
PROM1	Overlap: Fischer down_HSPC MUT down
TBXAS1	Overlap: Fischer down_HSPC MUT down
CDKN1A	No overlap: Fischer unique
RRM2B	No overlap: Fischer unique
SUSD6	No overlap: Fischer unique
DDB2	No overlap: Fischer unique
TIGAR	No overlap: Fischer unique
RPS27L	No overlap: Fischer unique
TNFRSF10B	No overlap: Fischer unique
ZMAT3	No overlap: Fischer unique
BAX	No overlap: Fischer unique
PGF	No overlap: Fischer unique
POLH	No overlap: Fischer unique
PPM1D	No overlap: Fischer unique
SULF2	No overlap: Fischer unique
XPC	No overlap: Fischer unique
FAS	No overlap: Fischer unique
GPR87	No overlap: Fischer unique
NINJ1	No overlap: Fischer unique
PLK2	No overlap: Fischer unique
TP53I3	No overlap: Fischer unique
ABCA12	No overlap: Fischer unique
CCNG1	No overlap: Fischer unique
DRAM1	No overlap: Fischer unique
FBXO22	No overlap: Fischer unique
ISCU	No overlap: Fischer unique
PHLDA3	No overlap: Fischer unique
SERPINB5	No overlap: Fischer unique
TRAF4	No overlap: Fischer unique
CES2	No overlap: Fischer unique
KITLG	No overlap: Fischer unique
BBC3	No overlap: Fischer unique
EDA2R	No overlap: Fischer unique
EPHA2	No overlap: Fischer unique
FDXR	No overlap: Fischer unique
LIF	No overlap: Fischer unique
SPATA18	No overlap: Fischer unique
TGFA	No overlap: Fischer unique
TLR3	No overlap: Fischer unique
ZNF79	No overlap: Fischer unique
CD82	No overlap: Fischer unique
CDIP1	No overlap: Fischer unique
CSF1	No overlap: Fischer unique
FUCA1	No overlap: Fischer unique
PADI4	No overlap: Fischer unique
PANK1	No overlap: Fischer unique
PRDM1	No overlap: Fischer unique
RAP2B	No overlap: Fischer unique
RRAD	No overlap: Fischer unique
ACTA2	No overlap: Fischer unique
EDN2	No overlap: Fischer unique
ALOX5	No overlap: Fischer unique
DDR1	No overlap: Fischer unique
E2F7	No overlap: Fischer unique
GLS2	No overlap: Fischer unique
GPX1	No overlap: Fischer unique
NOTCH1	No overlap: Fischer unique
RABGGTA	No overlap: Fischer unique
TNFRSF10A	No overlap: Fischer unique
SERPINE1	No overlap: Fischer unique
APAF1	No overlap: Fischer unique
BCL6	No overlap: Fischer unique
LIMK2	No overlap: Fischer unique
PIDD1	No overlap: Fischer unique
PML	No overlap: Fischer unique
VCAN	No overlap: Fischer unique
CEL	No overlap: Fischer unique
DAPK1	No overlap: Fischer unique
LMNA	No overlap: Fischer unique
PLTP	No overlap: Fischer unique
PRODH	No overlap: Fischer unique
RND3	No overlap: Fischer unique
RNF144B	No overlap: Fischer unique
S100A2	No overlap: Fischer unique
SEMA3B	No overlap: Fischer unique
STX6	No overlap: Fischer unique
TP73	No overlap: Fischer unique
TRIM32	No overlap: Fischer unique
AIFM2	No overlap: Fischer unique
CASP6	No overlap: Fischer unique
CAV1	No overlap: Fischer unique
CCNK	No overlap: Fischer unique
CGB7	No overlap: Fischer unique
DUSP5	No overlap: Fischer unique
HRAS	No overlap: Fischer unique
KRT8	No overlap: Fischer unique
PCBP4	No overlap: Fischer unique
PERP	No overlap: Fischer unique
PPM1J	No overlap: Fischer unique
RBM38	No overlap: Fischer unique
RHOC	No overlap: Fischer unique
SCN3B	No overlap: Fischer unique
TP53	No overlap: Fischer unique
VDR	No overlap: Fischer unique
ACAD11	No overlap: Fischer unique
APC	No overlap: Fischer unique
ARID3A	No overlap: Fischer unique
ARNT2	No overlap: Fischer unique
BANP	No overlap: Fischer unique
C10ORF54	No overlap: Fischer unique
CST5	No overlap: Fischer unique
CYP21A2	No overlap: Fischer unique
DKK1	No overlap: Fischer unique
ERAP1	No overlap: Fischer unique
FOS	No overlap: Fischer unique
GAMT	No overlap: Fischer unique
GCH1	No overlap: Fischer unique
GDF9	No overlap: Fischer unique
KIAA0513	No overlap: Fischer unique
LPIN1	No overlap: Fischer unique
MET	No overlap: Fischer unique
MMP2	No overlap: Fischer unique
NCF2	No overlap: Fischer unique
NOV	No overlap: Fischer unique
PLAGL1	No overlap: Fischer unique
PMS2	No overlap: Fischer unique
PRAP1	No overlap: Fischer unique
PTCHD4	No overlap: Fischer unique
PTEN	No overlap: Fischer unique
RCHY1	No overlap: Fischer unique
SEMA3F	No overlap: Fischer unique
SGK1	No overlap: Fischer unique
SYK	No overlap: Fischer unique
TLR6	No overlap: Fischer unique
TSC2	No overlap: Fischer unique
EGFR	No overlap: Fischer unique
TFAP2A	No overlap: Fischer unique
TFAP2C	No overlap: Fischer unique
AGT	No overlap: Fischer unique
AGTR1	No overlap: Fischer unique
AIFM1	No overlap: Fischer unique
APOB	No overlap: Fischer unique
APOBEC1	No overlap: Fischer unique
BAK1	No overlap: Fischer unique
BCL2L14	No overlap: Fischer unique
BDKRB2	No overlap: Fischer unique
BNIP3L	No overlap: Fischer unique
CASP1	No overlap: Fischer unique
CASP10	No overlap: Fischer unique
CHMP4C	No overlap: Fischer unique
CKM	No overlap: Fischer unique
COL18A1	No overlap: Fischer unique
COMT	No overlap: Fischer unique
CPT1C	No overlap: Fischer unique
CST3	No overlap: Fischer unique
CTF1	No overlap: Fischer unique
CTSD	No overlap: Fischer unique
CX3CL1	No overlap: Fischer unique
DEC1	No overlap: Fischer unique
DUSP4	No overlap: Fischer unique
DUSP6	No overlap: Fischer unique
EGR2	No overlap: Fischer unique
ERCC1	No overlap: Fischer unique
ESR1	No overlap: Fischer unique
FDFT1	No overlap: Fischer unique
FLT1	No overlap: Fischer unique
FOXF1	No overlap: Fischer unique
FOXP3	No overlap: Fischer unique
GAD2	No overlap: Fischer unique
GSTP1	No overlap: Fischer unique
HAMP	No overlap: Fischer unique
HDC	No overlap: Fischer unique
HIC1	No overlap: Fischer unique
HMGCR	No overlap: Fischer unique
IGFBP3	No overlap: Fischer unique
KLLN	No overlap: Fischer unique
MB	No overlap: Fischer unique
MFN2	No overlap: Fischer unique
MVK	No overlap: Fischer unique
NDRG1	No overlap: Fischer unique
NLRC4	No overlap: Fischer unique
NR0B2	No overlap: Fischer unique
NSG1	No overlap: Fischer unique
OGN	No overlap: Fischer unique
ORM2	No overlap: Fischer unique
PARK2	No overlap: Fischer unique
PAX2	No overlap: Fischer unique
PCDH10	No overlap: Fischer unique
PEBP1	No overlap: Fischer unique
PHF1	No overlap: Fischer unique
POMC	No overlap: Fischer unique
RAB6C	No overlap: Fischer unique
RP11-330H6.5	No overlap: Fischer unique
S100A9	No overlap: Fischer unique
SERPINA6	No overlap: Fischer unique
SH2D1A	No overlap: Fischer unique
SHBG	No overlap: Fischer unique
SIVA1	No overlap: Fischer unique
STAG1	No overlap: Fischer unique
TGM2	No overlap: Fischer unique
TLR10	No overlap: Fischer unique
TLR2	No overlap: Fischer unique
TLR4	No overlap: Fischer unique
TLR5	No overlap: Fischer unique
TLR8	No overlap: Fischer unique
TNFSF9	No overlap: Fischer unique
TP53AIP1	No overlap: Fischer unique
TYRP1	No overlap: Fischer unique
UBTD1	No overlap: Fischer unique
UNC5A	No overlap: Fischer unique
ZFP36	No overlap: Fischer unique
MLH1	No overlap: Fischer unique
HMGCLL1	No overlap: Fischer unique
IFI16	No overlap: Fischer unique
MPZL2	No overlap: Fischer unique
TP63	No overlap: Fischer unique
ULK2	No overlap: Fischer unique
FANCC	No overlap: Fischer unique
MAD1L1	No overlap: Fischer unique
CD44	No overlap: Fischer unique
F2R	No overlap: Fischer unique
RARA	No overlap: Fischer unique
BNIP3	No overlap: Fischer unique
ID2	No overlap: Fischer unique
IGF1R	No overlap: Fischer unique
AFP	No overlap: Fischer unique
APEX1	No overlap: Fischer unique
AR	No overlap: Fischer unique
ATR	No overlap: Fischer unique
BCL2	No overlap: Fischer unique
BIRC5	No overlap: Fischer unique
BRCA2	No overlap: Fischer unique
CBL	No overlap: Fischer unique
CCNB2	No overlap: Fischer unique
CDC20	No overlap: Fischer unique
CDKN2A	No overlap: Fischer unique
CHEK1	No overlap: Fischer unique
CKS2	No overlap: Fischer unique
CRYZ	No overlap: Fischer unique
DEF6	No overlap: Fischer unique
DUT	No overlap: Fischer unique
ECT2	No overlap: Fischer unique
EPCAM	No overlap: Fischer unique
FZD2	No overlap: Fischer unique
GBP1	No overlap: Fischer unique
GFI1	No overlap: Fischer unique
HNF4A	No overlap: Fischer unique
HPSE	No overlap: Fischer unique
HSP90AB1	No overlap: Fischer unique
KRT14	No overlap: Fischer unique
LARP1	No overlap: Fischer unique
LASP1	No overlap: Fischer unique
LGALS3	No overlap: Fischer unique
ME2	No overlap: Fischer unique
MTA1	No overlap: Fischer unique
MYC	No overlap: Fischer unique
MYOG	No overlap: Fischer unique
NANOG	No overlap: Fischer unique
NEK2	No overlap: Fischer unique
NOL3	No overlap: Fischer unique
NOS3	No overlap: Fischer unique
PIK3CA	No overlap: Fischer unique
PKD1	No overlap: Fischer unique
POLD1	No overlap: Fischer unique
PPARGC1A	No overlap: Fischer unique
PPARGC1B	No overlap: Fischer unique
PRC1	No overlap: Fischer unique
PTPN6	No overlap: Fischer unique
PTTG1	No overlap: Fischer unique
RAD17	No overlap: Fischer unique
RAD51	No overlap: Fischer unique
RECQL4	No overlap: Fischer unique
RFC4	No overlap: Fischer unique
SALL2	No overlap: Fischer unique
SCD	No overlap: Fischer unique
SLC2A4	No overlap: Fischer unique
SLC38A2	No overlap: Fischer unique
TDG	No overlap: Fischer unique
TFF2	No overlap: Fischer unique
TP53BP1	No overlap: Fischer unique
TPT1	No overlap: Fischer unique
TRPC7	No overlap: Fischer unique
UBD	No overlap: Fischer unique
UTF1	No overlap: Fischer unique
XPO1	No overlap: Fischer unique
YWHAG	No overlap: Fischer unique
CDC25B	No overlap: Fischer unique
DSP	No overlap: Fischer unique
MAP4	No overlap: Fischer unique
MAPK8	No overlap: Fischer unique
ME1	No overlap: Fischer unique
PSRC1	No overlap: Fischer unique
RAD23A	No overlap: Fischer unique
RBPJ	No overlap: Fischer unique
RTN4	No overlap: Fischer unique
SLC6A6	No overlap: Fischer unique
ANLN	No overlap: Fischer unique
CCNB1	No overlap: Fischer unique
MSH2	No overlap: Fischer unique
PLK1	No overlap: Fischer unique
SLC7A11	No overlap: Fischer unique
PTK2	No overlap: Fischer unique
CDK1	No overlap: Fischer unique
RSPO1	No overlap: HSPC MUT unique
C1orf228	No overlap: HSPC MUT unique
SELL	No overlap: HSPC MUT unique
MIR181A1HG	No overlap: HSPC MUT unique
PSME4	No overlap: HSPC MUT unique
PELI1	No overlap: HSPC MUT unique
PDK1	No overlap: HSPC MUT unique
IL1RAP	No overlap: HSPC MUT unique
TFRC	No overlap: HSPC MUT unique
CRHBP	No overlap: HSPC MUT unique
ARRDC3	No overlap: HSPC MUT unique
CD74	No overlap: HSPC MUT unique
RHAG	No overlap: HSPC MUT unique
GPR126	No overlap: HSPC MUT unique
GNG11	No overlap: HSPC MUT unique
AASS	No overlap: HSPC MUT unique
TIMP1	No overlap: HSPC MUT unique
ITM2A	No overlap: HSPC MUT unique
BEX1	No overlap: HSPC MUT unique
BEX2	No overlap: HSPC MUT unique
FHL1	No overlap: HSPC MUT unique
CLU	No overlap: HSPC MUT unique
MTSS1	No overlap: HSPC MUT unique
DENND3	No overlap: HSPC MUT unique
PLIN2	No overlap: HSPC MUT unique
TMEM246	No overlap: HSPC MUT unique
MAP3K8	No overlap: HSPC MUT unique
MDK	No overlap: HSPC MUT unique
LAG3	No overlap: HSPC MUT unique
SLC2A3	No overlap: HSPC MUT unique
ETV6	No overlap: HSPC MUT unique
SLC38A1	No overlap: HSPC MUT unique
NFE2	No overlap: HSPC MUT unique
PCDH9	No overlap: HSPC MUT unique
ATF7IP2	No overlap: HSPC MUT unique
MYL4	No overlap: HSPC MUT unique
FAM117A	No overlap: HSPC MUT unique
RP11-264B14.1	No overlap: HSPC MUT unique
AVP	No overlap: HSPC MUT unique
ZFAS1	No overlap: HSPC MUT unique
HCST	No overlap: HSPC MUT unique
LGALS1	No overlap: HSPC MUT unique
TMEM156	No overlap: HSPC MUT unique
FAM129A	No overlap: HSPC MUT unique
CD36	No overlap: HSPC MUT unique
CTSF	No overlap: HSPC MUT unique
APOE	No overlap: HSPC MUT unique
ZBTB43	No overlap: HSPC MUT unique
TSPAN2	No overlap: HSPC MUT unique
COTL1	No overlap: HSPC MUT unique
PTMS	No overlap: HSPC MUT unique
ANXA6	No overlap: HSPC MUT unique
MUM1	No overlap: HSPC MUT unique
JUN	No overlap: HSPC MUT unique
CA1	No overlap: HSPC MUT unique
NECAP1	No overlap: HSPC MUT unique
CCNL1	No overlap: HSPC MUT unique
CHKB	No overlap: HSPC MUT unique
YBX1	No overlap: HSPC MUT unique
ZNF292	No overlap: HSPC MUT unique
DDX39A	No overlap: HSPC MUT unique
DLK1	No overlap: HSPC MUT unique
RP11-468E2.4	No overlap: HSPC MUT unique
NPM1	No overlap: HSPC MUT unique
FAM127A	No overlap: HSPC MUT unique
TESC	No overlap: HSPC MUT unique
POLR2B	No overlap: HSPC MUT unique
TUBB6	No overlap: HSPC MUT unique
SFPQ	No overlap: HSPC MUT unique
ZC3H15	No overlap: HSPC MUT unique
IFITM1	No overlap: HSPC MUT unique
LUZP1	No overlap: HSPC MUT unique
HEMGN	No overlap: HSPC MUT unique
ANK1	No overlap: HSPC MUT unique
PPP1R14A	No overlap: HSPC MUT unique
IREB2	No overlap: HSPC MUT unique
ARPC5L	No overlap: HSPC MUT unique
IFIT3	No overlap: HSPC MUT unique
ADNP2	No overlap: HSPC MUT unique
SLC25A37	No overlap: HSPC MUT unique
LMO2	No overlap: HSPC MUT unique
LY6E	No overlap: HSPC MUT unique
MIR4435-1HG	No overlap: HSPC MUT unique
ZKSCAN1	No overlap: HSPC MUT unique
MTDH	No overlap: HSPC MUT unique
ZFP36L2	No overlap: HSPC MUT unique
PTPRE	No overlap: HSPC MUT unique
RCC2	No overlap: HSPC MUT unique
TIMM23	No overlap: HSPC MUT unique
PBXIP1	No overlap: HSPC MUT unique
PDLIM1	No overlap: HSPC MUT unique
PLXDC2	No overlap: HSPC MUT unique
EEF2	No overlap: HSPC MUT unique
EHD2	No overlap: HSPC MUT unique
SRSF10	No overlap: HSPC MUT unique
GUCY1A3	No overlap: HSPC MUT unique
GLUL	No overlap: HSPC MUT unique
RPL26	No overlap: HSPC MUT unique
CD97	No overlap: HSPC MUT unique
AJ006998.2	No overlap: HSPC MUT unique
IL8	No overlap: HSPC MUT unique
FAM46A	No overlap: HSPC MUT unique
WDR26	No overlap: HSPC MUT unique
CCDC12	No overlap: HSPC MUT unique
MEIS1	No overlap: HSPC MUT unique
GTPBP4	No overlap: HSPC MUT unique
TRIB2	No overlap: HSPC MUT unique
MAT2B	No overlap: HSPC MUT unique
FAM127B	No overlap: HSPC MUT unique
ILF3	No overlap: HSPC MUT unique
IQGAP1	No overlap: HSPC MUT unique
LAPTM4B	No overlap: HSPC MUT unique
MGAT4A	No overlap: HSPC MUT unique
MYO1F	No overlap: HSPC MUT unique
SERPINB6	No overlap: HSPC MUT unique
RP11-1275H24.3	No overlap: HSPC MUT unique
TPM4	No overlap: HSPC MUT unique
RANBP2	No overlap: HSPC MUT unique
RP11-367G6.3	No overlap: HSPC MUT unique
GAS5-AS1	No overlap: HSPC MUT unique
ZSCAN18	No overlap: HSPC MUT unique
RAB27B	No overlap: HSPC MUT unique
GPR56	No overlap: HSPC MUT unique
AHSA2	No overlap: HSPC MUT unique
MT-ND6	No overlap: HSPC MUT unique
NCF4	No overlap: HSPC MUT unique
ROBO3	No overlap: HSPC MUT unique
HNRNPM	No overlap: HSPC MUT unique
RGS1	No overlap: HSPC MUT unique
UBR4	No overlap: HSPC MUT unique
LCOR	No overlap: HSPC MUT unique
RP11-598F7.3	No overlap: HSPC MUT unique
APOC1	No overlap: HSPC MUT unique
CDKN2D	No overlap: HSPC MUT unique
PTP4A2	No overlap: HSPC MUT unique
SOCS2	No overlap: HSPC MUT unique
RTF1	No overlap: HSPC MUT unique
PRPF40A	No overlap: HSPC MUT unique
STAT1	No overlap: HSPC MUT unique
MLLT4	No overlap: HSPC MUT unique
ZNF326	No overlap: HSPC MUT unique
IQGAP2	No overlap: HSPC MUT unique
SSBP2	No overlap: HSPC MUT unique
NLRC5	No overlap: HSPC MUT unique
RRP12	No overlap: HSPC MUT unique
HMGXB4	No overlap: HSPC MUT unique
CEP170	No overlap: HSPC MUT unique
SIL1	No overlap: HSPC MUT unique
STMN3	No overlap: HSPC MUT unique
C14orf39	No overlap: HSPC MUT unique
CTDSPL	No overlap: HSPC MUT unique
WDR43	No overlap: HSPC MUT unique
RGS2	No overlap: HSPC MUT unique
MEX3C	No overlap: HSPC MUT unique
EREG	No overlap: HSPC MUT unique
CKB	No overlap: HSPC MUT unique
IFI6	No overlap: HSPC MUT unique
PHYKPL	No overlap: HSPC MUT unique
ZNRF1	No overlap: HSPC MUT unique
TIPARP	No overlap: HSPC MUT unique
MBOAT2	No overlap: HSPC MUT unique
EIF5B	No overlap: HSPC MUT unique
HLA-DPB1	No overlap: HSPC MUT unique
LST1	No overlap: HSPC MUT unique
EGR1	No overlap: HSPC MUT unique
YTHDC1	No overlap: HSPC MUT unique
PPM1A	No overlap: HSPC MUT unique
YWHAE	No overlap: HSPC MUT unique
DDX21	No overlap: HSPC MUT unique
MXD1	No overlap: HSPC MUT unique
TACC1	No overlap: HSPC MUT unique
GSTM2	No overlap: HSPC MUT unique
NACA2	No overlap: HSPC MUT unique
CD47	No overlap: HSPC MUT unique
EFHD2	No overlap: HSPC MUT unique
REL	No overlap: HSPC MUT unique
PHIP	No overlap: HSPC MUT unique
LINC00152	No overlap: HSPC MUT unique
TMEM173	No overlap: HSPC MUT unique
BCLAF1	No overlap: HSPC MUT unique
SRSF11	No overlap: HSPC MUT unique
TNRC18	No overlap: HSPC MUT unique
SLC35E1	No overlap: HSPC MUT unique
C7orf55	No overlap: HSPC MUT unique
RBBP6	No overlap: HSPC MUT unique
HLA-DRB5	No overlap: HSPC MUT unique
TRAPPC10	No overlap: HSPC MUT unique
TRAPPC1	No overlap: HSPC MUT unique
SNRPA1	No overlap: HSPC MUT unique
ATP6V0E1	No overlap: HSPC MUT unique
ITGB2	No overlap: HSPC MUT unique
PYCR2	No overlap: HSPC MUT unique
FCER1G	No overlap: HSPC MUT unique
CSF2RB	No overlap: HSPC MUT unique
H1FX	No overlap: HSPC MUT unique
IFI44	No overlap: HSPC MUT unique
CWC25	No overlap: HSPC MUT unique
USP16	No overlap: HSPC MUT unique
STK17B	No overlap: HSPC MUT unique
RELB	No overlap: HSPC MUT unique
NBEAL2	No overlap: HSPC MUT unique
AHCTF1	No overlap: HSPC MUT unique
RABGAP1	No overlap: HSPC MUT unique
USP11	No overlap: HSPC MUT unique
EPC1	No overlap: HSPC MUT unique
ITGB1	No overlap: HSPC MUT unique
MYCT1	No overlap: HSPC MUT unique
SAT2	No overlap: HSPC MUT unique
C1orf63	No overlap: HSPC MUT unique
RAB1A	No overlap: HSPC MUT unique
SSFA2	No overlap: HSPC MUT unique
POMP	No overlap: HSPC MUT unique
SYPL1	No overlap: HSPC MUT unique
TCEB1	No overlap: HSPC MUT unique
C12orf65	No overlap: HSPC MUT unique
ERGIC1	No overlap: HSPC MUT unique
HBB	No overlap: HSPC MUT unique
TNFSF13B	No overlap: HSPC MUT unique
FTH1	No overlap: HSPC MUT unique
ANXA2	No overlap: HSPC MUT unique
TPTEP1	No overlap: HSPC MUT unique
RB1CC1	No overlap: HSPC MUT unique
PPIF	No overlap: HSPC MUT unique
C5orf15	No overlap: HSPC MUT unique
S1PR4	No overlap: HSPC MUT unique
CNRIP1	No overlap: HSPC MUT unique
PHACTR2	No overlap: HSPC MUT unique
EIF2S3	No overlap: HSPC MUT unique
CYB5B	No overlap: HSPC MUT unique
C6orf48	No overlap: HSPC MUT unique
UBE2J1	No overlap: HSPC MUT unique
USP3	No overlap: HSPC MUT unique
BAZ1A	No overlap: HSPC MUT unique
CIR1	No overlap: HSPC MUT unique
DDX6	No overlap: HSPC MUT unique
DYRK1A	No overlap: HSPC MUT unique
MTRNR2L12	No overlap: HSPC MUT unique
HBD	No overlap: HSPC MUT unique
RAB5B	No overlap: HSPC MUT unique
PSMD12	No overlap: HSPC MUT unique
ABCF1	No overlap: HSPC MUT unique
TMEM11	No overlap: HSPC MUT unique
LAIR1	No overlap: HSPC MUT unique
GSTK1	No overlap: HSPC MUT unique
RBM25	No overlap: HSPC MUT unique
HSPB1	No overlap: HSPC MUT unique
TMCO3	No overlap: HSPC MUT unique
ATF4	No overlap: HSPC MUT unique
GATA2	No overlap: HSPC MUT unique
IDI1	No overlap: HSPC MUT unique
ING4	No overlap: HSPC MUT unique
DPPA4	No overlap: HSPC MUT unique
DHX15	No overlap: HSPC MUT unique
GAPT	No overlap: HSPC MUT unique
SRSF4	No overlap: HSPC MUT unique
TNFAIP3	No overlap: HSPC MUT unique
SRSF6	No overlap: HSPC MUT unique
ISG15	No overlap: HSPC MUT unique
KIF5B	No overlap: HSPC MUT unique
MBOAT7	No overlap: HSPC MUT unique
LSM4	No overlap: HSPC MUT unique
RAD23B	No overlap: HSPC MUT unique
STXBP5	No overlap: HSPC MUT unique
C5orf56	No overlap: HSPC MUT unique
HIAT1	No overlap: HSPC MUT unique
INF2	No overlap: HSPC MUT unique
ERCC-00046	No overlap: HSPC MUT unique
DSE	No overlap: HSPC MUT unique
GUCY1B3	No overlap: HSPC MUT unique
GABARAPL2	No overlap: HSPC MUT unique
UBE2Q2	No overlap: HSPC MUT unique
ATP11B	No overlap: HSPC MUT unique
EDARADD	No overlap: HSPC MUT unique
MLLT3	No overlap: HSPC MUT unique
GADD45G	No overlap: HSPC MUT unique
SH2B3	No overlap: HSPC MUT unique
CDK11A	No overlap: HSPC MUT unique
RIOK3	No overlap: HSPC MUT unique
THUMPD2	No overlap: HSPC MUT unique
YARS	No overlap: HSPC MUT unique
CCDC59	No overlap: HSPC MUT unique
NBEAL1	No overlap: HSPC MUT unique
ZNF281	No overlap: HSPC MUT unique
LSP1	No overlap: HSPC MUT unique
NEMF	No overlap: HSPC MUT unique
CALM3	No overlap: HSPC MUT unique
CD320	No overlap: HSPC MUT unique
UQCRQ	No overlap: HSPC MUT unique
CTD-2020K17.1	No overlap: HSPC MUT unique
HELZ	No overlap: HSPC MUT unique
SYAP1	No overlap: HSPC MUT unique
BRD8	No overlap: HSPC MUT unique
RAB3D	No overlap: HSPC MUT unique
DCTN6	No overlap: HSPC MUT unique
XPO4	No overlap: HSPC MUT unique
FAM91A1	No overlap: HSPC MUT unique
RNMT	No overlap: HSPC MUT unique
NUP54	No overlap: HSPC MUT unique
M6PR	No overlap: HSPC MUT unique
SDE2	No overlap: HSPC MUT unique
COA3	No overlap: HSPC MUT unique
TMEM107	No overlap: HSPC MUT unique
TPP2	No overlap: HSPC MUT unique
EMR2	No overlap: HSPC MUT unique
MED13L	No overlap: HSPC MUT unique
C7orf50	No overlap: HSPC MUT unique
UCP2	No overlap: HSPC MUT unique
TWISTNB	No overlap: HSPC MUT unique
HIST2H2AA4	No overlap: HSPC MUT unique
FBRS	No overlap: HSPC MUT unique
DESI2	No overlap: HSPC MUT unique
GAPDH	No overlap: HSPC MUT unique
SOCS3	No overlap: HSPC MUT unique
ETS2	No overlap: HSPC MUT unique
C1orf21	No overlap: HSPC MUT unique
PSMG1	No overlap: HSPC MUT unique
NDUFB9	No overlap: HSPC MUT unique
ITGA2B	No overlap: HSPC MUT unique
RIPK2	No overlap: HSPC MUT unique
JUNB	No overlap: HSPC MUT unique
ZNF714	No overlap: HSPC MUT unique
U2SURP	No overlap: HSPC MUT unique
LYL1	No overlap: HSPC MUT unique
SLC2A1	No overlap: HSPC MUT unique
BSPRY	No overlap: HSPC MUT unique
IFI44L	No overlap: HSPC MUT unique
MCTP2	No overlap: HSPC MUT unique
NET1	No overlap: HSPC MUT unique
MIS18BP1	No overlap: HSPC MUT unique
ZBTB20	No overlap: HSPC MUT unique
SLC39A4	No overlap: HSPC MUT unique
FLNA	No overlap: HSPC MUT unique
CENPF	No overlap: HSPC MUT unique
PSPC1	No overlap: HSPC MUT unique
VAMP2	No overlap: HSPC MUT unique
CCNDBP1	No overlap: HSPC MUT unique
CAMLG	No overlap: HSPC MUT unique
FRMD4B	No overlap: HSPC MUT unique
CHST12	No overlap: HSPC MUT unique
CHAF1A	No overlap: HSPC MUT unique
NRIP1	No overlap: HSPC MUT unique
ARF6	No overlap: HSPC MUT unique
HN1	No overlap: HSPC MUT unique
MSRB3	No overlap: HSPC MUT unique
AC006129.2	No overlap: HSPC MUT unique
PTAR1	No overlap: HSPC MUT unique
UBE2D2	No overlap: HSPC MUT unique
CTD-2647E9.3	No overlap: HSPC MUT unique
HDGF	No overlap: HSPC MUT unique
PPIB	No overlap: HSPC MUT unique
RLF	No overlap: HSPC MUT unique
MGLL	No overlap: HSPC MUT unique
PICALM	No overlap: HSPC MUT unique
EIF2AK2	No overlap: HSPC MUT unique
EIF3J-AS1	No overlap: HSPC MUT unique
ORAI3	No overlap: HSPC MUT unique
NAA25	No overlap: HSPC MUT unique
SLBP	No overlap: HSPC MUT unique
SERPINB1	No overlap: HSPC MUT unique
LMAN2	No overlap: HSPC MUT unique
CD84	No overlap: HSPC MUT unique
ENY2	No overlap: HSPC MUT unique
SMEK1	No overlap: HSPC MUT unique
ATAD2	No overlap: HSPC MUT unique
CD55	No overlap: HSPC MUT unique
PER1	No overlap: HSPC MUT unique
PRKDC	No overlap: HSPC MUT unique
IK	No overlap: HSPC MUT unique
TMEM50A	No overlap: HSPC MUT unique
CCNT2	No overlap: HSPC MUT unique
CDK11B	No overlap: HSPC MUT unique
HLA-DQA1	No overlap: HSPC MUT unique
BST2	No overlap: HSPC MUT unique
RHBDD2	No overlap: HSPC MUT unique
PDLIM5	No overlap: HSPC MUT unique
CPNE1	No overlap: HSPC MUT unique
PNP	No overlap: HSPC MUT unique
PSMC1	No overlap: HSPC MUT unique
SH3GLB1	No overlap: HSPC MUT unique
GFI1B	No overlap: HSPC MUT unique
ACTR2	No overlap: HSPC MUT unique
ASXL1	No overlap: HSPC MUT unique
YTHDF3	No overlap: HSPC MUT unique
AC002454.1	No overlap: HSPC MUT unique
FAM160B1	No overlap: HSPC MUT unique
ERI1	No overlap: HSPC MUT unique
RBM17	No overlap: HSPC MUT unique
SEC61B	No overlap: HSPC MUT unique
PPDPF	No overlap: HSPC MUT unique
CENPU	No overlap: HSPC MUT unique
YME1L1	No overlap: HSPC MUT unique
MKNK1	No overlap: HSPC MUT unique
GLRX5	No overlap: HSPC MUT unique
SUPT6H	No overlap: HSPC MUT unique
KIDINS220	No overlap: HSPC MUT unique
CDC42	No overlap: HSPC MUT unique
SH3RF1	No overlap: HSPC MUT unique
ELMO1	No overlap: HSPC MUT unique
CTNNA1	No overlap: HSPC MUT unique
PPTC7	No overlap: HSPC MUT unique
KPNA2	No overlap: HSPC MUT unique
HIF1A	No overlap: HSPC MUT unique
CTSW	No overlap: HSPC MUT unique
CSTF3	No overlap: HSPC MUT unique
NCBP2-AS2	No overlap: HSPC MUT unique
ABTB1	No overlap: HSPC MUT unique
RP5-827C21.2	No overlap: HSPC MUT unique
MAGED2	No overlap: HSPC MUT unique
LMBRD1	No overlap: HSPC MUT unique
HMBS	No overlap: HSPC MUT unique
ZNF451	No overlap: HSPC MUT unique
NBPF14	No overlap: HSPC MUT unique
CCND2	No overlap: HSPC MUT unique
KLF13	No overlap: HSPC MUT unique
RAB5A	No overlap: HSPC MUT unique
EGFL7	No overlap: HSPC MUT unique
LYPLA1	No overlap: HSPC MUT unique
USP9X	No overlap: HSPC MUT unique
NAPG	No overlap: HSPC MUT unique
NR4A2	No overlap: HSPC MUT unique
NBAS	No overlap: HSPC MUT unique
ATP8B4	No overlap: HSPC MUT unique
COPS2	No overlap: HSPC MUT unique
HECTD1	No overlap: HSPC MUT unique
CCM2	No overlap: HSPC MUT unique
AMT	No overlap: HSPC MUT unique
EML4	No overlap: HSPC MUT unique
FAM133B	No overlap: HSPC MUT unique
MOB1B	No overlap: HSPC MUT unique
SMARCA4	No overlap: HSPC MUT unique
MPC2	No overlap: HSPC MUT unique
OGFRL1	No overlap: HSPC MUT unique
PDCD5	No overlap: HSPC MUT unique
UQCRH	No overlap: HSPC MUT unique
ST8SIA6	No overlap: HSPC MUT unique
BTN3A2	No overlap: HSPC MUT unique
YY1	No overlap: HSPC MUT unique
RABGGTB	No overlap: HSPC MUT unique
EIF1B	No overlap: HSPC MUT unique
RLIM	No overlap: HSPC MUT unique
BOLA3	No overlap: HSPC MUT unique
PSMG2	No overlap: HSPC MUT unique
BIRC6	No overlap: HSPC MUT unique
IKBKB	No overlap: HSPC MUT unique
WAC	No overlap: HSPC MUT unique
FNIP1	No overlap: HSPC MUT unique
ACTN1	No overlap: HSPC MUT unique
RIF1	No overlap: HSPC MUT unique
MLTK	No overlap: HSPC MUT unique
VAMP5	No overlap: HSPC MUT unique
NUPL1	No overlap: HSPC MUT unique
GTF3C6	No overlap: HSPC MUT unique
GOLGA8A	No overlap: HSPC MUT unique
TTI2	No overlap: HSPC MUT unique
KDM5A	No overlap: HSPC MUT unique
WSB1	No overlap: HSPC MUT unique
ERG	No overlap: HSPC MUT unique
TFR2	No overlap: HSPC MUT unique
TOMM5	No overlap: HSPC MUT unique
CLDN15	No overlap: HSPC MUT unique
GTF2B	No overlap: HSPC MUT unique
RSBN1L	No overlap: HSPC MUT unique
CNOT2	No overlap: HSPC MUT unique
SURF4	No overlap: HSPC MUT unique
HSPA14	No overlap: HSPC MUT unique
SF3B14	No overlap: HSPC MUT unique
FLI1	No overlap: HSPC MUT unique
KBTBD2	No overlap: HSPC MUT unique
DDAH2	No overlap: HSPC MUT unique
RBM22	No overlap: HSPC MUT unique
PTPN7	No overlap: HSPC MUT unique
SAMSN1	No overlap: HSPC MUT unique
MYO9B	No overlap: HSPC MUT unique
AKIRIN1	No overlap: HSPC MUT unique
SNX9	No overlap: HSPC MUT unique
C16orf87	No overlap: HSPC MUT unique
MIER1	No overlap: HSPC MUT unique
KANSL2	No overlap: HSPC MUT unique
RNF167	No overlap: HSPC MUT unique
GMFB	No overlap: HSPC MUT unique
BLOC1S2	No overlap: HSPC MUT unique
RCSD1	No overlap: HSPC MUT unique
SIAH2	No overlap: HSPC MUT unique
L3HYPDH	No overlap: HSPC MUT unique
TMED4	No overlap: HSPC MUT unique
OSGIN2	No overlap: HSPC MUT unique
ZNF350	No overlap: HSPC MUT unique
CCDC88B	No overlap: HSPC MUT unique
SSR2	No overlap: HSPC MUT unique
MMRN1	No overlap: HSPC MUT unique
USP14	No overlap: HSPC MUT unique
SMIM1	No overlap: HSPC MUT unique
HSBP1L1	No overlap: HSPC MUT unique
SCRN2	No overlap: HSPC MUT unique
AAK1	No overlap: HSPC MUT unique
RAB2A	No overlap: HSPC MUT unique
TOX4	No overlap: HSPC MUT unique
GNG5	No overlap: HSPC MUT unique
GGNBP2	No overlap: HSPC MUT unique
DBI	No overlap: HSPC MUT unique
ZC3H11A	No overlap: HSPC MUT unique
COX8A	No overlap: HSPC MUT unique
PIM3	No overlap: HSPC MUT unique
SLC25A11	No overlap: HSPC MUT unique
SYNCRIP	No overlap: HSPC MUT unique
CLTC	No overlap: HSPC MUT unique
DYNC1H1	No overlap: HSPC MUT unique
BCL11A	No overlap: HSPC MUT unique
SLC25A33	No overlap: HSPC MUT unique
OBSL1	No overlap: HSPC MUT unique
NOP58	No overlap: HSPC MUT unique
CWC15	No overlap: HSPC MUT unique
LTV1	No overlap: HSPC MUT unique
SMOX	No overlap: HSPC MUT unique
HPGDS	No overlap: HSPC MUT unique
MBIP	No overlap: HSPC MUT unique
CD59	No overlap: HSPC MUT unique
HMG20B	No overlap: HSPC MUT unique
MDM4	No overlap: HSPC MUT unique
GNA12	No overlap: HSPC MUT unique
POM121	No overlap: HSPC MUT unique
PRKCH	No overlap: HSPC MUT unique
PSMA3	No overlap: HSPC MUT unique
TOMM20	No overlap: HSPC MUT unique
DYNLL1	No overlap: HSPC MUT unique
PPP1R12A	No overlap: HSPC MUT unique
C11orf49	No overlap: HSPC MUT unique
TAF11	No overlap: HSPC MUT unique
CALN1	No overlap: HSPC MUT unique
SCAF11	No overlap: HSPC MUT unique
GALNT2	No overlap: HSPC MUT unique
FAR1	No overlap: HSPC MUT unique
MCM4	No overlap: HSPC MUT unique
SEC63	No overlap: HSPC MUT unique
LARS	No overlap: HSPC MUT unique
TP53I13	No overlap: HSPC MUT unique
HERC1	No overlap: HSPC MUT unique
YTHDF2	No overlap: HSPC MUT unique
BZW1	No overlap: HSPC MUT unique
FBXO7	No overlap: HSPC MUT unique
CNP	No overlap: HSPC MUT unique
CUL5	No overlap: HSPC MUT unique
SLA	No overlap: HSPC MUT unique
UBL5	No overlap: HSPC MUT unique
SPTLC2	No overlap: HSPC MUT unique
SUMO1	No overlap: HSPC MUT unique
RNF168	No overlap: HSPC MUT unique
NGDN	No overlap: HSPC MUT unique
KPNA3	No overlap: HSPC MUT unique
MTHFD2L	No overlap: HSPC MUT unique
RICTOR	No overlap: HSPC MUT unique
NUP153	No overlap: HSPC MUT unique
CHKA	No overlap: HSPC MUT unique
HIST2H2AC	No overlap: HSPC MUT unique
ADPGK	No overlap: HSPC MUT unique
CHD4	No overlap: HSPC MUT unique
ZNF880	No overlap: HSPC MUT unique
SPOP	No overlap: HSPC MUT unique
HIST1H2BG	No overlap: HSPC MUT unique
MVP	No overlap: HSPC MUT unique
NGFRAP1	No overlap: HSPC MUT unique
SQLE	No overlap: HSPC MUT unique
BNIP2	No overlap: HSPC MUT unique
RPS19BP1	No overlap: HSPC MUT unique
SEC24B	No overlap: HSPC MUT unique
DHX29	No overlap: HSPC MUT unique
PPP1R10	No overlap: HSPC MUT unique
BAG5	No overlap: HSPC MUT unique
SLC25A36	No overlap: HSPC MUT unique
CPSF1	No overlap: HSPC MUT unique
NDUFB2	No overlap: HSPC MUT unique
PREB	No overlap: HSPC MUT unique
SMC3	No overlap: HSPC MUT unique
RAB13	No overlap: HSPC MUT unique
ELK3	No overlap: HSPC MUT unique
TCP1	No overlap: HSPC MUT unique
FMNL1	No overlap: HSPC MUT unique
GYPC	No overlap: HSPC MUT unique
SP100	No overlap: HSPC MUT unique
MED10	No overlap: HSPC MUT unique
MRPL47	No overlap: HSPC MUT unique
STK24	No overlap: HSPC MUT unique
NOTCH2NL	No overlap: HSPC MUT unique
TMIGD2	No overlap: HSPC MUT unique
TOP1	No overlap: HSPC MUT unique
CNST	No overlap: HSPC MUT unique
MPST	No overlap: HSPC MUT unique
COPS3	No overlap: HSPC MUT unique
CDC5L	No overlap: HSPC MUT unique
YWHAH	No overlap: HSPC MUT unique
RPF1	No overlap: HSPC MUT unique
NREP	No overlap: HSPC MUT unique
PDE6G	No overlap: HSPC MUT unique
C2orf68	No overlap: HSPC MUT unique
EVL	No overlap: HSPC MUT unique
H1F0	No overlap: HSPC MUT unique
CIB1	No overlap: HSPC MUT unique
SPCS3	No overlap: HSPC MUT unique
MED6	No overlap: HSPC MUT unique
DHX9	No overlap: HSPC MUT unique
IFNGR1	No overlap: HSPC MUT unique
RAD21	No overlap: HSPC MUT unique
MTPAP	No overlap: HSPC MUT unique
SRI	No overlap: HSPC MUT unique
ZFP36L1	No overlap: HSPC MUT unique
SSH2	No overlap: HSPC MUT unique
ELP5	No overlap: HSPC MUT unique
ATP6V1H	No overlap: HSPC MUT unique
WBP2	No overlap: HSPC MUT unique
CKS1B	No overlap: HSPC MUT unique
BAZ2A	No overlap: HSPC MUT unique
GSTM1	No overlap: HSPC MUT unique
CYLD	No overlap: HSPC MUT unique
CASP8	No overlap: HSPC MUT unique
PUM1	No overlap: HSPC MUT unique
CRIP2	No overlap: HSPC MUT unique
TAPT1	No overlap: HSPC MUT unique
BOP1	No overlap: HSPC MUT unique
PPHLN1	No overlap: HSPC MUT unique
PSMA6	No overlap: HSPC MUT unique
TBPL1	No overlap: HSPC MUT unique
RBM6	No overlap: HSPC MUT unique
TRO	No overlap: HSPC MUT unique
KPNA6	No overlap: HSPC MUT unique
RANBP1	No overlap: HSPC MUT unique
TSPAN4	No overlap: HSPC MUT unique
PPP1R15B	No overlap: HSPC MUT unique
ZNF121	No overlap: HSPC MUT unique
IFRD1	No overlap: HSPC MUT unique
PSMD14	No overlap: HSPC MUT unique
EIF3A	No overlap: HSPC MUT unique
DSTYK	No overlap: HSPC MUT unique
WARS	No overlap: HSPC MUT unique
PRPF4B	No overlap: HSPC MUT unique
CYTL1	No overlap: HSPC MUT unique
HBS1L	No overlap: HSPC MUT unique
ADAM28	No overlap: HSPC MUT unique
TMEM205	No overlap: HSPC MUT unique
BSDC1	No overlap: HSPC MUT unique
UBA7	No overlap: HSPC MUT unique
ERCC-00003	No overlap: HSPC MUT unique
SPRY1	No overlap: HSPC MUT unique
SERPING1	No overlap: HSPC MUT unique
HLA-DQB1	No overlap: HSPC MUT unique
CD34	No overlap: HSPC MUT unique
TTC1	No overlap: HSPC MUT unique
COPZ1	No overlap: HSPC MUT unique
ROGDI	No overlap: HSPC MUT unique
ASAH1	No overlap: HSPC MUT unique
ITCH	No overlap: HSPC MUT unique
MTURN	No overlap: HSPC MUT unique
RNASEH1	No overlap: HSPC MUT unique
ABHD14B	No overlap: HSPC MUT unique
CORO1A	No overlap: HSPC MUT unique
ZFP91	No overlap: HSPC MUT unique
TMEM220	No overlap: HSPC MUT unique
TRADD	No overlap: HSPC MUT unique
N4BP2L2	No overlap: HSPC MUT unique
GBAS	No overlap: HSPC MUT unique
ASCC2	No overlap: HSPC MUT unique
FIS1	No overlap: HSPC MUT unique
MYB	No overlap: HSPC MUT unique
GOLGA4	No overlap: HSPC MUT unique
CXXC5	No overlap: HSPC MUT unique
SCAF4	No overlap: HSPC MUT unique
UBR5	No overlap: HSPC MUT unique
GTF2IRD2B	No overlap: HSPC MUT unique
HERPUD1	No overlap: HSPC MUT unique
RBPMS	No overlap: HSPC MUT unique
TESPA1	No overlap: HSPC MUT unique
FAM53C	No overlap: HSPC MUT unique
PTPRCAP	No overlap: HSPC MUT unique
R3HDM4	No overlap: HSPC MUT unique
RWDD1	No overlap: HSPC MUT unique
ERCC-00042	No overlap: HSPC MUT unique
TMEM43	No overlap: HSPC MUT unique
SORL1	No overlap: HSPC MUT unique
BIVM	No overlap: HSPC MUT unique
C17orf62	No overlap: HSPC MUT unique
AKR1B1	No overlap: HSPC MUT unique
WHAMM	No overlap: HSPC MUT unique
SREK1IP1	No overlap: HSPC MUT unique
MED30	No overlap: HSPC MUT unique
POLR1C	No overlap: HSPC MUT unique
MPHOSPH8	No overlap: HSPC MUT unique
POLE3	No overlap: HSPC MUT unique
FABP5	No overlap: HSPC MUT unique
KRR1	No overlap: HSPC MUT unique
ERCC-00136	No overlap: HSPC MUT unique
PILRB	No overlap: HSPC MUT unique
MAFF	No overlap: HSPC MUT unique
TIAL1	No overlap: HSPC MUT unique
CDC42SE2	No overlap: HSPC MUT unique
RABL2A	No overlap: HSPC MUT unique
UBAC1	No overlap: HSPC MUT unique
CLEC2B	No overlap: HSPC MUT unique
GGH	No overlap: HSPC MUT unique
TBRG1	No overlap: HSPC MUT unique
CYTH4	No overlap: HSPC MUT unique
PIEZO1	No overlap: HSPC MUT unique
MAPRE2	No overlap: HSPC MUT unique
SDCBP	No overlap: HSPC MUT unique
RNF138	No overlap: HSPC MUT unique
NECAP2	No overlap: HSPC MUT unique
RP11-486G15.2	No overlap: HSPC MUT unique
HNRNPA3	No overlap: HSPC MUT unique
CD81	No overlap: HSPC MUT unique
LGALS8	No overlap: HSPC MUT unique
KIAA0101	No overlap: HSPC MUT unique
HEXDC	No overlap: HSPC MUT unique
GPATCH2L	No overlap: HSPC MUT unique
PNRC1	No overlap: HSPC MUT unique
TOMM7	No overlap: HSPC MUT unique
PRSS21	No overlap: HSPC MUT unique
GIMAP7	No overlap: HSPC MUT unique
CASP2	No overlap: HSPC MUT unique
CLK4	No overlap: HSPC MUT unique
CBX6	No overlap: HSPC MUT unique
CCDC88A	No overlap: HSPC MUT unique
USP39	No overlap: HSPC MUT unique
USP12	No overlap: HSPC MUT unique
CEP68	No overlap: HSPC MUT unique
P4HTM	No overlap: HSPC MUT unique
ACD	No overlap: HSPC MUT unique
RAB37	No overlap: HSPC MUT unique
NBPF10	No overlap: HSPC MUT unique
MED13	No overlap: HSPC MUT unique
CDCA7	No overlap: HSPC MUT unique
RNF19A	No overlap: HSPC MUT unique
JMJD1C	No overlap: HSPC MUT unique
HDAC2	No overlap: HSPC MUT unique
INO80D	No overlap: HSPC MUT unique
DPYSL2	No overlap: HSPC MUT unique
TMEM87A	No overlap: HSPC MUT unique
CBWD2	No overlap: HSPC MUT unique
GRK6	No overlap: HSPC MUT unique
RSF1	No overlap: HSPC MUT unique
ALYREF	No overlap: HSPC MUT unique
CCDC23	No overlap: HSPC MUT unique
ADI1	No overlap: HSPC MUT unique
TMC6	No overlap: HSPC MUT unique
SLC35A4	No overlap: HSPC MUT unique
PRKAA1	No overlap: HSPC MUT unique
ABHD2	No overlap: HSPC MUT unique
TXNL1	No overlap: HSPC MUT unique
OPA1	No overlap: HSPC MUT unique
MORC3	No overlap: HSPC MUT unique
SH3GL1	No overlap: HSPC MUT unique
FAM126B	No overlap: HSPC MUT unique
CDC42BPA	No overlap: HSPC MUT unique
CELF1	No overlap: HSPC MUT unique
NR3C1	No overlap: HSPC MUT unique
JARID2	No overlap: HSPC MUT unique
POLE4	No overlap: HSPC MUT unique
SPNS3	No overlap: HSPC MUT unique
PDIA6	No overlap: HSPC MUT unique
GNPTAB	No overlap: HSPC MUT unique
WDR54	No overlap: HSPC MUT unique
KDM3A	No overlap: HSPC MUT unique
COG3	No overlap: HSPC MUT unique
CACNB2	No overlap: HSPC MUT unique
TIMMDC1	No overlap: HSPC MUT unique
ZCCHC11	No overlap: HSPC MUT unique
PSMC6	No overlap: HSPC MUT unique
HLA-F	No overlap: HSPC MUT unique
PSMD6	No overlap: HSPC MUT unique
KRI1	No overlap: HSPC MUT unique
SLTM	No overlap: HSPC MUT unique
RIOK1	No overlap: HSPC MUT unique
HNRNPL	No overlap: HSPC MUT unique
TYMS	No overlap: HSPC MUT unique
SMARCC2	No overlap: HSPC MUT unique
IL2RG	No overlap: HSPC MUT unique
TAF7	No overlap: HSPC MUT unique
DR1	No overlap: HSPC MUT unique
ALDH1A1	No overlap: HSPC MUT unique
MCM5	No overlap: HSPC MUT unique
CUL3	No overlap: HSPC MUT unique
SERINC3	No overlap: HSPC MUT unique
RBM26	No overlap: HSPC MUT unique
ILKAP	No overlap: HSPC MUT unique
MRPS15	No overlap: HSPC MUT unique
HSPA1B	No overlap: HSPC MUT unique
ACSS1	No overlap: HSPC MUT unique
TMEM14B	No overlap: HSPC MUT unique
TAPSAR1	No overlap: HSPC MUT unique
SCN9A	No overlap: HSPC MUT unique
PFDN2	No overlap: HSPC MUT unique
ATAD3A	No overlap: HSPC MUT unique
MAD2L1BP	No overlap: HSPC MUT unique
SUCO	No overlap: HSPC MUT unique
PPP1R18	No overlap: HSPC MUT unique
SPG20	No overlap: HSPC MUT unique
CITED2	No overlap: HSPC MUT unique
RAB11A	No overlap: HSPC MUT unique
NPR3	No overlap: HSPC MUT unique
PON2	No overlap: HSPC MUT unique
CLSTN1	No overlap: HSPC MUT unique
BHLHE40	No overlap: HSPC MUT unique
BCKDK	No overlap: HSPC MUT unique
FAM49B	No overlap: HSPC MUT unique
ERCC-00060	No overlap: HSPC MUT unique
C11orf68	No overlap: HSPC MUT unique
RSRC2	No overlap: HSPC MUT unique
TM9SF3	No overlap: HSPC MUT unique
RP11-47A8.5	No overlap: HSPC MUT unique
KIAA0226	No overlap: HSPC MUT unique
CWF19L1	No overlap: HSPC MUT unique
AKAP8L	No overlap: HSPC MUT unique
PTBP1	No overlap: HSPC MUT unique
SKAP2	No overlap: HSPC MUT unique
CUL4A	No overlap: HSPC MUT unique
PRKCB	No overlap: HSPC MUT unique
PIP4K2A	No overlap: HSPC MUT unique
TXNRD1	No overlap: HSPC MUT unique
AGFG1	No overlap: HSPC MUT unique
DDX52	No overlap: HSPC MUT unique
ATP2B4	No overlap: HSPC MUT unique
BRWD1	No overlap: HSPC MUT unique
SNX17	No overlap: HSPC MUT unique
AC084018.1	No overlap: HSPC MUT unique
CSNK1D	No overlap: HSPC MUT unique
DNAAF2	No overlap: HSPC MUT unique
MKLN1	No overlap: HSPC MUT unique
NAA16	No overlap: HSPC MUT unique
ZFAND1	No overlap: HSPC MUT unique
UBR1	No overlap: HSPC MUT unique
SMCHD1	No overlap: HSPC MUT unique
NIPBL	No overlap: HSPC MUT unique
CHD1L	No overlap: HSPC MUT unique
TIMM50	No overlap: HSPC MUT unique
TPM1	No overlap: HSPC MUT unique
FRG1B	No overlap: HSPC MUT unique
RAB14	No overlap: HSPC MUT unique
UBA2	No overlap: HSPC MUT unique
RHOG	No overlap: HSPC MUT unique
KLF2	No overlap: HSPC MUT unique
MPLKIP	No overlap: HSPC MUT unique
RNF139	No overlap: HSPC MUT unique
INO80	No overlap: HSPC MUT unique
PRRC2B	No overlap: HSPC MUT unique
RABL2B	No overlap: HSPC MUT unique
BRD4	No overlap: HSPC MUT unique
DCXR	No overlap: HSPC MUT unique
APEH	No overlap: HSPC MUT unique
SLMAP	No overlap: HSPC MUT unique
CAMK1D	No overlap: HSPC MUT unique
UBE2A	No overlap: HSPC MUT unique
GNA13	No overlap: HSPC MUT unique
BAG1	No overlap: HSPC MUT unique
TMEM14A	No overlap: HSPC MUT unique
SNRNP200	No overlap: HSPC MUT unique
PPP2R2A	No overlap: HSPC MUT unique
PEPD	No overlap: HSPC MUT unique
MBOAT1	No overlap: HSPC MUT unique
MX1	No overlap: HSPC MUT unique
PLEKHM2	No overlap: HSPC MUT unique
TNIP1	No overlap: HSPC MUT unique
CNIH4	No overlap: HSPC MUT unique
PCNA	No overlap: HSPC MUT unique
SLC35C2	No overlap: HSPC MUT unique
TSTA3	No overlap: HSPC MUT unique
UCHL3	No overlap: HSPC MUT unique
RAB4B	No overlap: HSPC MUT unique
ATP2A2	No overlap: HSPC MUT unique
PWWP2A	No overlap: HSPC MUT unique
NT5C3B	No overlap: HSPC MUT unique
NIPSNAP1	No overlap: HSPC MUT unique
MEN1	No overlap: HSPC MUT unique
ARL6IP1	No overlap: HSPC MUT unique
FAM216A	No overlap: HSPC MUT unique
ACSF3	No overlap: HSPC MUT unique
SCFD1	No overlap: HSPC MUT unique
NT5C3A	No overlap: HSPC MUT unique
ASPSCR1	No overlap: HSPC MUT unique
RGPD6	No overlap: HSPC MUT unique
NT5M	No overlap: HSPC MUT unique
CPA3	No overlap: HSPC MUT unique
OTUD4	No overlap: HSPC MUT unique
TRIP12	No overlap: HSPC MUT unique
PRKD2	No overlap: HSPC MUT unique
CAPNS1	No overlap: HSPC MUT unique
MT-ND4L	No overlap: HSPC MUT unique
LYSMD2	No overlap: HSPC MUT unique
LRCH4	No overlap: HSPC MUT unique
PIGQ	No overlap: HSPC MUT unique
PPP6C	No overlap: HSPC MUT unique
HIST1H2BK	No overlap: HSPC MUT unique
GBP2	No overlap: HSPC MUT unique
RP11-354E11.2	No overlap: HSPC MUT unique
EP300	No overlap: HSPC MUT unique
HERC2	No overlap: HSPC MUT unique
TPP1	No overlap: HSPC MUT unique
MED4	No overlap: HSPC MUT unique
TOMM40	No overlap: HSPC MUT unique
XPNPEP1	No overlap: HSPC MUT unique
HELLS	No overlap: HSPC MUT unique
UFD1L	No overlap: HSPC MUT unique
ALDH2	No overlap: HSPC MUT unique
ZMYM5	No overlap: HSPC MUT unique
CPPED1	No overlap: HSPC MUT unique
TRIM33	No overlap: HSPC MUT unique
P2RX1	No overlap: HSPC MUT unique
MIF4GD	No overlap: HSPC MUT unique
HDDC2	No overlap: HSPC MUT unique
SMS	No overlap: HSPC MUT unique
KCMF1	No overlap: HSPC MUT unique
RAP2C	No overlap: HSPC MUT unique
BCCIP	No overlap: HSPC MUT unique
ANKLE2	No overlap: HSPC MUT unique
LINC00998	No overlap: HSPC MUT unique
STRADB	No overlap: HSPC MUT unique
TOB1	No overlap: HSPC MUT unique
RANBP9	No overlap: HSPC MUT unique
PDCL3	No overlap: HSPC MUT unique
XRN2	No overlap: HSPC MUT unique
BRIX1	No overlap: HSPC MUT unique
TMEM41A	No overlap: HSPC MUT unique
UBE2J2	No overlap: HSPC MUT unique
STRAP	No overlap: HSPC MUT unique
KDM2A	No overlap: HSPC MUT unique
TCEA1	No overlap: HSPC MUT unique
TSPYL1	No overlap: HSPC MUT unique
ARL5A	No overlap: HSPC MUT unique
C17orf89	No overlap: HSPC MUT unique
NMD3	No overlap: HSPC MUT unique
AC013449.1	No overlap: HSPC MUT unique
MCFD2	No overlap: HSPC MUT unique
ZYX	No overlap: HSPC MUT unique
WRNIP1	No overlap: HSPC MUT unique
EVA1B	No overlap: HSPC MUT unique
TGOLN2	No overlap: HSPC MUT unique
NRAS	No overlap: HSPC MUT unique
MTIF3	No overlap: HSPC MUT unique
G3BP2	No overlap: HSPC MUT unique
BAG6	No overlap: HSPC MUT unique
ERMP1	No overlap: HSPC MUT unique
GGA1	No overlap: HSPC MUT unique
DEAF1	No overlap: HSPC MUT unique
ACIN1	No overlap: HSPC MUT unique
DENND4A	No overlap: HSPC MUT unique
NUDCD3	No overlap: HSPC MUT unique
DDIT3	No overlap: HSPC MUT unique
SNHG8	No overlap: HSPC MUT unique
IPO5	No overlap: HSPC MUT unique
LRRC8A	No overlap: HSPC MUT unique
TUG1	No overlap: HSPC MUT unique
TGIF2	No overlap: HSPC MUT unique
DTD1	No overlap: HSPC MUT unique
HSPA1A	No overlap: HSPC MUT unique
EIF4E	No overlap: HSPC MUT unique
WBP5	No overlap: HSPC MUT unique
RAD50	No overlap: HSPC MUT unique
CSNK2A2	No overlap: HSPC MUT unique
MIR24-2	No overlap: HSPC MUT unique
NOTCH2	No overlap: HSPC MUT unique
METAP2	No overlap: HSPC MUT unique
SRSF1	No overlap: HSPC MUT unique
ERCC-00043	No overlap: HSPC MUT unique
IPO11	No overlap: HSPC MUT unique
RMDN1	No overlap: HSPC MUT unique
PCGF5	No overlap: HSPC MUT unique
UROS	No overlap: HSPC MUT unique
INSR	No overlap: HSPC MUT unique
RAB7A	No overlap: HSPC MUT unique
TACC3	No overlap: HSPC MUT unique
UNK	No overlap: HSPC MUT unique
SNRNP25	No overlap: HSPC MUT unique
NSUN2	No overlap: HSPC MUT unique
VCL	No overlap: HSPC MUT unique
MAGOH	No overlap: HSPC MUT unique
PTPN11	No overlap: HSPC MUT unique
RCL1	No overlap: HSPC MUT unique
MAPRE1	No overlap: HSPC MUT unique
NUDT5	No overlap: HSPC MUT unique
CBFB	No overlap: HSPC MUT unique
PPIH	No overlap: HSPC MUT unique
ELF2	No overlap: HSPC MUT unique
TKT	No overlap: HSPC MUT unique
ABLIM1	No overlap: HSPC MUT unique
LBR	No overlap: HSPC MUT unique
PCSK7	No overlap: HSPC MUT unique
ARPC5	No overlap: HSPC MUT unique
C1D	No overlap: HSPC MUT unique
KAT6A	No overlap: HSPC MUT unique
B3GNT2	No overlap: HSPC MUT unique
UBE2B	No overlap: HSPC MUT unique
RAMP1	No overlap: HSPC MUT unique
USP33	No overlap: HSPC MUT unique
CARD8	No overlap: HSPC MUT unique
HMGCL	No overlap: HSPC MUT unique
STAM	No overlap: HSPC MUT unique
NUMB	No overlap: HSPC MUT unique
EIF3J	No overlap: HSPC MUT unique
TCOF1	No overlap: HSPC MUT unique
NAAA	No overlap: HSPC MUT unique
PTRHD1	No overlap: HSPC MUT unique
RP6-206I17.1	No overlap: HSPC MUT unique
RIMKLB	No overlap: HSPC MUT unique
RNF149	No overlap: HSPC MUT unique
ZDHHC2	No overlap: HSPC MUT unique
PRDX3	No overlap: HSPC MUT unique
PPCS	No overlap: HSPC MUT unique
MGAT1	No overlap: HSPC MUT unique
GBP4	No overlap: HSPC MUT unique
IL1B	No overlap: HSPC MUT unique
ATXN3	No overlap: HSPC MUT unique
MRPL22	No overlap: HSPC MUT unique
TFG	No overlap: HSPC MUT unique
ID1	No overlap: HSPC MUT unique
HLA-DMB	No overlap: HSPC MUT unique
MARVELD1	No overlap: HSPC MUT unique
ZNF512	No overlap: HSPC MUT unique
GANAB	No overlap: HSPC MUT unique
DDX56	No overlap: HSPC MUT unique
PABPC4	No overlap: HSPC MUT unique
HEATR5B	No overlap: HSPC MUT unique
C1orf27	No overlap: HSPC MUT unique
C7orf73	No overlap: HSPC MUT unique
GSTM4	No overlap: HSPC MUT unique
SHANK3	No overlap: HSPC MUT unique
SLMO2	No overlap: HSPC MUT unique
TIMM17A	No overlap: HSPC MUT unique
UBQLN1	No overlap: HSPC MUT unique
CAND1	No overlap: HSPC MUT unique
POMGNT1	No overlap: HSPC MUT unique
RAE1	No overlap: HSPC MUT unique
RAB11B	No overlap: HSPC MUT unique
C21orf58	No overlap: HSPC MUT unique
NUCB1	No overlap: HSPC MUT unique
CTDSPL2	No overlap: HSPC MUT unique
PITHD1	No overlap: HSPC MUT unique
UPF3A	No overlap: HSPC MUT unique
RRP1B	No overlap: HSPC MUT unique
ZNF644	No overlap: HSPC MUT unique
ZFAND2B	No overlap: HSPC MUT unique
PCM1	No overlap: HSPC MUT unique
TRIP6	No overlap: HSPC MUT unique
DNM1L	No overlap: HSPC MUT unique
C14orf119	No overlap: HSPC MUT unique
ATAD3B	No overlap: HSPC MUT unique
MED17	No overlap: HSPC MUT unique
AC010642.1	No overlap: HSPC MUT unique
GALT	No overlap: HSPC MUT unique
ITGAE	No overlap: HSPC MUT unique
SEH1L	No overlap: HSPC MUT unique
EXOC7	No overlap: HSPC MUT unique
PSMB10	No overlap: HSPC MUT unique
REPIN1	No overlap: HSPC MUT unique
WDR45B	No overlap: HSPC MUT unique
JMJD6	No overlap: HSPC MUT unique
TRPV2	No overlap: HSPC MUT unique
PLEKHF2	No overlap: HSPC MUT unique
CUX1	No overlap: HSPC MUT unique
ATE1	No overlap: HSPC MUT unique
ATXN2	No overlap: HSPC MUT unique
KDM3B	No overlap: HSPC MUT unique
CEBPG	No overlap: HSPC MUT unique
CMTM7	No overlap: HSPC MUT unique
TMBIM4.1	No overlap: HSPC MUT unique
MYO1G	No overlap: HSPC MUT unique
TRAF3IP3	No overlap: HSPC MUT unique
CDC40	No overlap: HSPC MUT unique
ERAP2	No overlap: HSPC MUT unique
UTP23	No overlap: HSPC MUT unique
NUFIP2	No overlap: HSPC MUT unique
CDK2AP2	No overlap: HSPC MUT unique
UBQLN2	No overlap: HSPC MUT unique
AP1G1	No overlap: HSPC MUT unique
DPP8	No overlap: HSPC MUT unique
CAST	No overlap: HSPC MUT unique
GAR1	No overlap: HSPC MUT unique
BTAF1	No overlap: HSPC MUT unique
CEP135	No overlap: HSPC MUT unique
FAM69B	No overlap: HSPC MUT unique
UTP11L	No overlap: HSPC MUT unique
MED23	No overlap: HSPC MUT unique
CCNH	No overlap: HSPC MUT unique
SUPT16H	No overlap: HSPC MUT unique
SNX2	No overlap: HSPC MUT unique
DDA1	No overlap: HSPC MUT unique
RP11-488L18.10	No overlap: HSPC MUT unique
SEC14L1	No overlap: HSPC MUT unique
KCTD20	No overlap: HSPC MUT unique
BLOC1S6	No overlap: HSPC MUT unique
DDX49	No overlap: HSPC MUT unique
ATP6V0A2	No overlap: HSPC MUT unique
PRKRA	No overlap: HSPC MUT unique
IKZF1	No overlap: HSPC MUT unique
PRKAR1A	No overlap: HSPC MUT unique
UBA6	No overlap: HSPC MUT unique
TPMT	No overlap: HSPC MUT unique
HDAC1	No overlap: HSPC MUT unique
NCLN	No overlap: HSPC MUT unique
GMNN	No overlap: HSPC MUT unique
TCF4	No overlap: HSPC MUT unique
ABCC4	No overlap: HSPC MUT unique
TRIM27	No overlap: HSPC MUT unique
LAP3	No overlap: HSPC MUT unique
NIPAL3	No overlap: HSPC MUT unique
HPCAL1	No overlap: HSPC MUT unique
ZNRD1-AS1	No overlap: HSPC MUT unique
SMIM19	No overlap: HSPC MUT unique
NR6A1	No overlap: HSPC MUT unique
ZMYM2	No overlap: HSPC MUT unique
FAHD2B	No overlap: HSPC MUT unique
MAGT1	No overlap: HSPC MUT unique
ARL17B	No overlap: HSPC MUT unique
BRAF	No overlap: HSPC MUT unique
STAT5B	No overlap: HSPC MUT unique
GALK1	No overlap: HSPC MUT unique
METTL23	No overlap: HSPC MUT unique
PRPF6	No overlap: HSPC MUT unique
SPAG9	No overlap: HSPC MUT unique
KRIT1	No overlap: HSPC MUT unique
RBM14	No overlap: HSPC MUT unique
TNRC6C	No overlap: HSPC MUT unique
TTF1	No overlap: HSPC MUT unique
CXCL2	No overlap: HSPC MUT unique
INTS10	No overlap: HSPC MUT unique
COQ10B	No overlap: HSPC MUT unique
RBBP4	No overlap: HSPC MUT unique
KLF3	No overlap: HSPC MUT unique
ACBD3	No overlap: HSPC MUT unique
STAT6	No overlap: HSPC MUT unique
MCM2	No overlap: HSPC MUT unique
ANKZF1	No overlap: HSPC MUT unique
S100A10	No overlap: HSPC MUT unique
DNAJC8	No overlap: HSPC MUT unique
TARS	No overlap: HSPC MUT unique
OBFC1	No overlap: HSPC MUT unique
RNF187	No overlap: HSPC MUT unique
RILPL2	No overlap: HSPC MUT unique
GDI1	No overlap: HSPC MUT unique
KIAA2018	No overlap: HSPC MUT unique
PUM2	No overlap: HSPC MUT unique
FASTK	No overlap: HSPC MUT unique
CREBZF	No overlap: HSPC MUT unique
SFSWAP	No overlap: HSPC MUT unique
RBM33	No overlap: HSPC MUT unique
LEPROTL1	No overlap: HSPC MUT unique
ATP2A3	No overlap: HSPC MUT unique
GPCPD1	No overlap: HSPC MUT unique
ING5	No overlap: HSPC MUT unique
PIK3IP1	No overlap: HSPC MUT unique
TMEM109	No overlap: HSPC MUT unique
PIKFYVE	No overlap: HSPC MUT unique
ZNF236	No overlap: HSPC MUT unique
ESCO1	No overlap: HSPC MUT unique
PIGH	No overlap: HSPC MUT unique
STON2	No overlap: HSPC MUT unique
GIGYF1	No overlap: HSPC MUT unique
NDUFAF6	No overlap: HSPC MUT unique
FHL2	No overlap: HSPC MUT unique
FLOT2	No overlap: HSPC MUT unique
LRRC8B	No overlap: HSPC MUT unique
FAM168B	No overlap: HSPC MUT unique
OSER1	No overlap: HSPC MUT unique
ELOVL6	No overlap: HSPC MUT unique
TOB2	No overlap: HSPC MUT unique
HIST2H2BE	No overlap: HSPC MUT unique
CDK12	No overlap: HSPC MUT unique
ERCC-00145	No overlap: HSPC MUT unique
CCDC28A	No overlap: HSPC MUT unique
MTRNR2L8	No overlap: HSPC MUT unique
KHSRP	No overlap: HSPC MUT unique
MAN1A1	No overlap: HSPC MUT unique
FAM210B	No overlap: HSPC MUT unique
ZNF317	No overlap: HSPC MUT unique
TIPRL	No overlap: HSPC MUT unique
EFCAB14	No overlap: HSPC MUT unique
SNX27	No overlap: HSPC MUT unique
PGPEP1	No overlap: HSPC MUT unique
TCIRG1	No overlap: HSPC MUT unique
UGGT1	No overlap: HSPC MUT unique
TCTA	No overlap: HSPC MUT unique
PTGS1	No overlap: HSPC MUT unique
CASP3	No overlap: HSPC MUT unique
POLR2D	No overlap: HSPC MUT unique
PDIA4	No overlap: HSPC MUT unique
ZNF521	No overlap: HSPC MUT unique
CREG1	No overlap: HSPC MUT unique
KRAS	No overlap: HSPC MUT unique
TBC1D15	No overlap: HSPC MUT unique
RNF220	No overlap: HSPC MUT unique
FAM111A	No overlap: HSPC MUT unique
GTF2IRD2	No overlap: HSPC MUT unique
ERCC-00009	No overlap: HSPC MUT unique
TBK1	No overlap: HSPC MUT unique
TOPORS-AS1	No overlap: HSPC MUT unique
NBPF15	No overlap: HSPC MUT unique
NDUFB5	No overlap: HSPC MUT unique
CBFA2T3	No overlap: HSPC MUT unique
BLVRB	No overlap: HSPC MUT unique
PCYT2	No overlap: HSPC MUT unique
LYRM1	No overlap: HSPC MUT unique
MPHOSPH9	No overlap: HSPC MUT unique
PAK1IP1	No overlap: HSPC MUT unique
VAT1	No overlap: HSPC MUT unique
CYB5R1	No overlap: HSPC MUT unique
SDHC	No overlap: HSPC MUT unique
CCDC69	No overlap: HSPC MUT unique
ZSWIM7	No overlap: HSPC MUT unique
XPA	No overlap: HSPC MUT unique
LNPEP	No overlap: HSPC MUT unique
PLCB2	No overlap: HSPC MUT unique
CREBBP	No overlap: HSPC MUT unique
C4orf48	No overlap: HSPC MUT unique
ANKRD54	No overlap: HSPC MUT unique
MED16	No overlap: HSPC MUT unique
USP47	No overlap: HSPC MUT unique
TRMT5	No overlap: HSPC MUT unique
BRAP	No overlap: HSPC MUT unique
HEXB	No overlap: HSPC MUT unique
HAGH	No overlap: HSPC MUT unique
POLR3GL	No overlap: HSPC MUT unique
INO80C	No overlap: HSPC MUT unique
KIF13A	No overlap: HSPC MUT unique
GLOD4	No overlap: HSPC MUT unique
KMT2E-AS1	No overlap: HSPC MUT unique
CTSC	No overlap: HSPC MUT unique
WASH4P	No overlap: HSPC MUT unique
C1orf162	No overlap: HSPC MUT unique
KCNN4	No overlap: HSPC MUT unique
ARHGEF6	No overlap: HSPC MUT unique
SNAPIN	No overlap: HSPC MUT unique
BCL7A	No overlap: HSPC MUT unique
STX8	No overlap: HSPC MUT unique
SENP2	No overlap: HSPC MUT unique
HDAC7	No overlap: HSPC MUT unique
YTHDF1	No overlap: HSPC MUT unique
LITAF	No overlap: HSPC MUT unique
CDIPT	No overlap: HSPC MUT unique
WDR41	No overlap: HSPC MUT unique
KIF2A	No overlap: HSPC MUT unique
MCUR1	No overlap: HSPC MUT unique
CTB-31O20.2	No overlap: HSPC MUT unique
RGS10	No overlap: HSPC MUT unique
GGPS1	No overlap: HSPC MUT unique
CLNS1A	No overlap: HSPC MUT unique
DNAJC19	No overlap: HSPC MUT unique
MRFAP1L1	No overlap: HSPC MUT unique
SMC2	No overlap: HSPC MUT unique
PPP1R2	No overlap: HSPC MUT unique
DTNBP1	No overlap: HSPC MUT unique
CTD-3184A7.4	No overlap: HSPC MUT unique
THOC1	No overlap: HSPC MUT unique
MST4	No overlap: HSPC MUT unique
TCEAL4	No overlap: HSPC MUT unique
MPRIP	No overlap: HSPC MUT unique
TMEM126A	No overlap: HSPC MUT unique
TOPORS	No overlap: HSPC MUT unique
PHF14	No overlap: HSPC MUT unique
ARFRP1	No overlap: HSPC MUT unique
DGAT1	No overlap: HSPC MUT unique
ZFAND2A	No overlap: HSPC MUT unique
EXOSC9	No overlap: HSPC MUT unique
DBNL	No overlap: HSPC MUT unique
LYAR	No overlap: HSPC MUT unique
THAP11	No overlap: HSPC MUT unique
ZBTB44	No overlap: HSPC MUT unique
PIAS2	No overlap: HSPC MUT unique
PTGES2	No overlap: HSPC MUT unique
RAB3GAP2	No overlap: HSPC MUT unique
TMEM70	No overlap: HSPC MUT unique
TMEM41B	No overlap: HSPC MUT unique
TRIM24	No overlap: HSPC MUT unique
ATP6V1B2	No overlap: HSPC MUT unique
GSDMD	No overlap: HSPC MUT unique
MRPS33	No overlap: HSPC MUT unique
RNPC3	No overlap: HSPC MUT unique
CHP1	No overlap: HSPC MUT unique
LAMTOR3	No overlap: HSPC MUT unique
KIAA0247	No overlap: HSPC MUT unique
PAXBP1	No overlap: HSPC MUT unique
SF3B3	No overlap: HSPC MUT unique
ZNF639	No overlap: HSPC MUT unique
CCDC90B	No overlap: HSPC MUT unique
FBXL12	No overlap: HSPC MUT unique
SLU7	No overlap: HSPC MUT unique
TPRKB	No overlap: HSPC MUT unique
HIST1H2AE	No overlap: HSPC MUT unique
KIAA0907	No overlap: HSPC MUT unique
NFKBIE	No overlap: HSPC MUT unique
CRLF3	No overlap: HSPC MUT unique
TPM2	No overlap: HSPC MUT unique
MGMT	No overlap: HSPC MUT unique
PANK2	No overlap: HSPC MUT unique
PTPN2	No overlap: HSPC MUT unique
CCNT1	No overlap: HSPC MUT unique
WDR45	No overlap: HSPC MUT unique
DPF2	No overlap: HSPC MUT unique
PRKACB	No overlap: HSPC MUT unique
HCFC1	No overlap: HSPC MUT unique
SUPT5H	No overlap: HSPC MUT unique
PPM1B	No overlap: HSPC MUT unique
VRK1	No overlap: HSPC MUT unique
C16orf54	No overlap: HSPC MUT unique
HNRNPA0	No overlap: HSPC MUT unique
PGP	No overlap: HSPC MUT unique
SVIP	No overlap: HSPC MUT unique
RBM7	No overlap: HSPC MUT unique
CEP350	No overlap: HSPC MUT unique
CD2BP2	No overlap: HSPC MUT unique
DPY30	No overlap: HSPC MUT unique
ERGIC3	No overlap: HSPC MUT unique
MTRF1L	No overlap: HSPC MUT unique
MMP19	No overlap: HSPC MUT unique
FLII	No overlap: HSPC MUT unique
VASP	No overlap: HSPC MUT unique
DCUN1D5	No overlap: HSPC MUT unique
KIAA1586	No overlap: HSPC MUT unique
LSM2	No overlap: HSPC MUT unique
WDR48	No overlap: HSPC MUT unique
KIAA1430	No overlap: HSPC MUT unique
LCP2	No overlap: HSPC MUT unique
SPDYE3	No overlap: HSPC MUT unique
NBPF12	No overlap: HSPC MUT unique
MGST3	No overlap: HSPC MUT unique
CAB39	No overlap: HSPC MUT unique
KATNBL1	No overlap: HSPC MUT unique
MAFG	No overlap: HSPC MUT unique
ZNRD1	No overlap: HSPC MUT unique
NFRKB	No overlap: HSPC MUT unique
TTF2	No overlap: HSPC MUT unique
RASA4B	No overlap: HSPC MUT unique
STARD3	No overlap: HSPC MUT unique
KLHL6	No overlap: HSPC MUT unique
CMTM6	No overlap: HSPC MUT unique
PAPSS1	No overlap: HSPC MUT unique
RAD54L2	No overlap: HSPC MUT unique
POGLUT1	No overlap: HSPC MUT unique
RNF4	No overlap: HSPC MUT unique
ZC3H8	No overlap: HSPC MUT unique
NFAT5	No overlap: HSPC MUT unique
SUMF2	No overlap: HSPC MUT unique
RFWD3	No overlap: HSPC MUT unique
CEP70	No overlap: HSPC MUT unique
DOCK2	No overlap: HSPC MUT unique
FAHD2A	No overlap: HSPC MUT unique
FGD3	No overlap: HSPC MUT unique
KIAA0430	No overlap: HSPC MUT unique
ICA1	No overlap: HSPC MUT unique
RP1-241P17.4	No overlap: HSPC MUT unique
GAK	No overlap: HSPC MUT unique
SERPINB9	No overlap: HSPC MUT unique
PAXIP1-AS1	No overlap: HSPC MUT unique
RAB4A	No overlap: HSPC MUT unique
CSRP1	No overlap: HSPC MUT unique
EPB41L4A-AS1	No overlap: HSPC MUT unique
EMID1	No overlap: HSPC MUT unique
CIZ1	No overlap: HSPC MUT unique
HIST2H4B	No overlap: HSPC MUT unique
HCG18	No overlap: HSPC MUT unique
NDUFA2	No overlap: HSPC MUT unique
THAP9-AS1	No overlap: HSPC MUT unique
ECI2	No overlap: HSPC MUT unique
WDR11	No overlap: HSPC MUT unique
GNAI1	No overlap: HSPC MUT unique
DNAJB1	No overlap: HSPC MUT unique
VPS72	No overlap: HSPC MUT unique
SMG7	No overlap: HSPC MUT unique
AKR7A2	No overlap: HSPC MUT unique
LYRM7	No overlap: HSPC MUT unique
UBE2K	No overlap: HSPC MUT unique
C7orf55-LUC7L2	No overlap: HSPC MUT unique
RC3H2	No overlap: HSPC MUT unique
MYCN	No overlap: HSPC MUT unique
SUZ12	No overlap: HSPC MUT unique
P2RX4	No overlap: HSPC MUT unique
MAP7	No overlap: HSPC MUT unique
HOXB2	No overlap: HSPC MUT unique
ZNF148	No overlap: HSPC MUT unique
RNF5	No overlap: HSPC MUT unique
RFC1	No overlap: HSPC MUT unique
PIN4	No overlap: HSPC MUT unique
HSD17B11	No overlap: HSPC MUT unique
CD9	No overlap: HSPC MUT unique
TLE4	No overlap: HSPC MUT unique
ISG20	No overlap: HSPC MUT unique
USP36	No overlap: HSPC MUT unique
CNTRL	No overlap: HSPC MUT unique
ZNF395	No overlap: HSPC MUT unique
NECAB1	No overlap: HSPC MUT unique
CEP95	No overlap: HSPC MUT unique
ERLIN1	No overlap: HSPC MUT unique
DENND4C	No overlap: HSPC MUT unique
PSTPIP2	No overlap: HSPC MUT unique
ZNF333	No overlap: HSPC MUT unique
NAA10	No overlap: HSPC MUT unique
RRN3	No overlap: HSPC MUT unique
SEL1L	No overlap: HSPC MUT unique
STK10	No overlap: HSPC MUT unique
MED28	No overlap: HSPC MUT unique
ERLEC1	No overlap: HSPC MUT unique
NPIPA1	No overlap: HSPC MUT unique
TMEM134	No overlap: HSPC MUT unique
MAP4K5	No overlap: HSPC MUT unique
CCDC53	No overlap: HSPC MUT unique
PSMD5-AS1	No overlap: HSPC MUT unique
ARID1A	No overlap: HSPC MUT unique
VPS35	No overlap: HSPC MUT unique
NSMCE1	No overlap: HSPC MUT unique
TMEM80	No overlap: HSPC MUT unique
GATAD1	No overlap: HSPC MUT unique
BAG4	No overlap: HSPC MUT unique
HAX1	No overlap: HSPC MUT unique
UBN1	No overlap: HSPC MUT unique
TM4SF1	No overlap: HSPC MUT unique
ISCA1	No overlap: HSPC MUT unique
ACYP1	No overlap: HSPC MUT unique
SLX1B	No overlap: HSPC MUT unique
USP1	No overlap: HSPC MUT unique
PTPN4	No overlap: HSPC MUT unique
NSUN5	No overlap: HSPC MUT unique
EIF4G3	No overlap: HSPC MUT unique
TPRA1	No overlap: HSPC MUT unique
LTBP4	No overlap: HSPC MUT unique
PLXND1	No overlap: HSPC MUT unique
IL6ST	No overlap: HSPC MUT unique
RB1	No overlap: HSPC MUT unique
PHF20	No overlap: HSPC MUT unique
NUDT21	No overlap: HSPC MUT unique
ZBED5	No overlap: HSPC MUT unique
TANK	No overlap: HSPC MUT unique
NBPF16	No overlap: HSPC MUT unique
FAM195A	No overlap: HSPC MUT unique
ORAI2	No overlap: HSPC MUT unique
INTS3	No overlap: HSPC MUT unique
MRPL9	No overlap: HSPC MUT unique
KATNB1	No overlap: HSPC MUT unique
ARL2BP	No overlap: HSPC MUT unique
FBRSL1	No overlap: HSPC MUT unique
PTPLAD2	No overlap: HSPC MUT unique
FOPNL	No overlap: HSPC MUT unique
AKIRIN2	No overlap: HSPC MUT unique
CCDC171	No overlap: HSPC MUT unique
UBXN7	No overlap: HSPC MUT unique
LINC00667	No overlap: HSPC MUT unique
STYXL1	No overlap: HSPC MUT unique
PNPT1	No overlap: HSPC MUT unique
PCMTD2	No overlap: HSPC MUT unique
PRKD3	No overlap: HSPC MUT unique
HSF1	No overlap: HSPC MUT unique
ZNF791	No overlap: HSPC MUT unique
WDR75	No overlap: HSPC MUT unique
RALA	No overlap: HSPC MUT unique
DIMT1	No overlap: HSPC MUT unique
VAV1	No overlap: HSPC MUT unique
PJA2	No overlap: HSPC MUT unique
MEAF6	No overlap: HSPC MUT unique
POLD4	No overlap: HSPC MUT unique
G3BP1	No overlap: HSPC MUT unique
MDN1	No overlap: HSPC MUT unique
MTL5	No overlap: HSPC MUT unique
AKAP8	No overlap: HSPC MUT unique
GADD45B	No overlap: HSPC MUT unique
VHL	No overlap: HSPC MUT unique
MOAP1	No overlap: HSPC MUT unique
NLRP1	No overlap: HSPC MUT unique
TUBB2B	No overlap: HSPC MUT unique
SAMD4B	No overlap: HSPC MUT unique
PDLIM2	No overlap: HSPC MUT unique
AKAP17A	No overlap: HSPC MUT unique
RP1-257A7.5	No overlap: HSPC MUT unique
ACOT1	No overlap: HSPC MUT unique
TYK2	No overlap: HSPC MUT unique
LMO4	No overlap: HSPC MUT unique
MOB4	No overlap: HSPC MUT unique
NIT2	No overlap: HSPC MUT unique
ORAI1	No overlap: HSPC MUT unique
SLC18A2	No overlap: HSPC MUT unique
KIAA0368	No overlap: HSPC MUT unique
GOPC	No overlap: HSPC MUT unique
WIBG	No overlap: HSPC MUT unique
ERCC-00092	No overlap: HSPC MUT unique
C1orf123	No overlap: HSPC MUT unique
AIP	No overlap: HSPC MUT unique
LEPRE1	No overlap: HSPC MUT unique
PCED1A	No overlap: HSPC MUT unique
WDR60	No overlap: HSPC MUT unique
FAM212A	No overlap: HSPC MUT unique
GPAA1	No overlap: HSPC MUT unique
ZBTB16	No overlap: HSPC MUT unique
HSD17B8	No overlap: HSPC MUT unique
NRDE2	No overlap: HSPC MUT unique
UBXN2A	No overlap: HSPC MUT unique
ZNF146	No overlap: HSPC MUT unique
TMA16	No overlap: HSPC MUT unique
ABHD10	No overlap: HSPC MUT unique
CEBPB	No overlap: HSPC MUT unique
ATP5EP2	No overlap: HSPC MUT unique
GTF2H5	No overlap: HSPC MUT unique
CARHSP1	No overlap: HSPC MUT unique
MAP4K1	No overlap: HSPC MUT unique
CCPG1	No overlap: HSPC MUT unique
MED15	No overlap: HSPC MUT unique
BRD9	No overlap: HSPC MUT unique
TEX264	No overlap: HSPC MUT unique
SPIN1	No overlap: HSPC MUT unique
RAB34	No overlap: HSPC MUT unique
SCOC	No overlap: HSPC MUT unique
ALKBH5	No overlap: HSPC MUT unique
YLPM1	No overlap: HSPC MUT unique
RUNX3	No overlap: HSPC MUT unique
PMPCB	No overlap: HSPC MUT unique
COG4	No overlap: HSPC MUT unique
FOXO1	No overlap: HSPC MUT unique
TSPYL2	No overlap: HSPC MUT unique
MARCH7	No overlap: HSPC MUT unique
ABHD14A	No overlap: HSPC MUT unique
MRPS14	No overlap: HSPC MUT unique
UBAP1	No overlap: HSPC MUT unique
UBL7	No overlap: HSPC MUT unique
ARMC10	No overlap: HSPC MUT unique
EXOSC3	No overlap: HSPC MUT unique
NFE2L2	No overlap: HSPC MUT unique
YRDC	No overlap: HSPC MUT unique
ARL14EP	No overlap: HSPC MUT unique
C11orf48	No overlap: HSPC MUT unique
NHLRC3	No overlap: HSPC MUT unique
ARHGEF7	No overlap: HSPC MUT unique
SLC48A1	No overlap: HSPC MUT unique
VEZF1	No overlap: HSPC MUT unique
TTC37	No overlap: HSPC MUT unique
PTRF	No overlap: HSPC MUT unique
RPS10P7	No overlap: HSPC MUT unique
MGAT4B	No overlap: HSPC MUT unique
GATAD2B	No overlap: HSPC MUT unique
VPS13B	No overlap: HSPC MUT unique
IBTK	No overlap: HSPC MUT unique
DIP2A	No overlap: HSPC MUT unique
RNF11	No overlap: HSPC MUT unique
CNPY2	No overlap: HSPC MUT unique
AMZ2	No overlap: HSPC MUT unique
NSD1	No overlap: HSPC MUT unique
NPIPB3	No overlap: HSPC MUT unique
FAM178A	No overlap: HSPC MUT unique
ARMCX3	No overlap: HSPC MUT unique
EXOC4	No overlap: HSPC MUT unique
TMEM91	No overlap: HSPC MUT unique
RREB1	No overlap: HSPC MUT unique
PDAP1	No overlap: HSPC MUT unique
TRAM1	No overlap: HSPC MUT unique
ZCCHC8	No overlap: HSPC MUT unique
CRTAP	No overlap: HSPC MUT unique
ASNA1	No overlap: HSPC MUT unique
RBM19	No overlap: HSPC MUT unique
LTA4H	No overlap: HSPC MUT unique
R3HDM2	No overlap: HSPC MUT unique
ALS2	No overlap: HSPC MUT unique
LGALS9	No overlap: HSPC MUT unique
ERCC-00108	No overlap: HSPC MUT unique
SIPA1	No overlap: HSPC MUT unique
GSTM3	No overlap: HSPC MUT unique
RNF40	No overlap: HSPC MUT unique
COASY	No overlap: HSPC MUT unique
ADNP	No overlap: HSPC MUT unique
PPM1F	No overlap: HSPC MUT unique
RABL6	No overlap: HSPC MUT unique
BTBD1	No overlap: HSPC MUT unique
DHPS	No overlap: HSPC MUT unique
ING3	No overlap: HSPC MUT unique
PRELID1	No overlap: HSPC MUT unique
SWAP70	No overlap: HSPC MUT unique
FAM134A	No overlap: HSPC MUT unique
TLK2	No overlap: HSPC MUT unique
FOXK1	No overlap: HSPC MUT unique
CREB1	No overlap: HSPC MUT unique
UHRF2	No overlap: HSPC MUT unique
PPWD1	No overlap: HSPC MUT unique
SEC16A	No overlap: HSPC MUT unique
ACCS	No overlap: HSPC MUT unique
HDAC3	No overlap: HSPC MUT unique
CPNE8	No overlap: HSPC MUT unique
MRPL43	No overlap: HSPC MUT unique
VPS4A	No overlap: HSPC MUT unique
SLC39A1	No overlap: HSPC MUT unique
APMAP	No overlap: HSPC MUT unique
RCN1	No overlap: HSPC MUT unique
UTP6	No overlap: HSPC MUT unique
PDHB	No overlap: HSPC MUT unique
ABI2	No overlap: HSPC MUT unique
FBXW5	No overlap: HSPC MUT unique
SLC38A10	No overlap: HSPC MUT unique
DCTN2	No overlap: HSPC MUT unique
VRK3	No overlap: HSPC MUT unique
FAM89B	No overlap: HSPC MUT unique
NUDT4	No overlap: HSPC MUT unique
NTPCR	No overlap: HSPC MUT unique
BLOC1S1	No overlap: HSPC MUT unique
ARSD	No overlap: HSPC MUT unique
WDR37	No overlap: HSPC MUT unique
MITD1	No overlap: HSPC MUT unique
PGAM1	No overlap: HSPC MUT unique
SP3	No overlap: HSPC MUT unique
FBXL5	No overlap: HSPC MUT unique
ARRDC2	No overlap: HSPC MUT unique
MCCC1	No overlap: HSPC MUT unique
UBE2H	No overlap: HSPC MUT unique
XXbac-BPG299F13.17	No overlap: HSPC MUT unique
CCT5	No overlap: HSPC MUT unique
ATXN7L3B	No overlap: HSPC MUT unique
BTK	No overlap: HSPC MUT unique
API5	No overlap: HSPC MUT unique
CAPN2	No overlap: HSPC MUT unique
RPA2	No overlap: HSPC MUT unique
ARHGAP1	No overlap: HSPC MUT unique
TIMM10	No overlap: HSPC MUT unique
MESDC2	No overlap: HSPC MUT unique
HNRNPAB	No overlap: HSPC MUT unique
PIM2	No overlap: HSPC MUT unique
GGCT	No overlap: HSPC MUT unique
CASP4	No overlap: HSPC MUT unique
TBRG4	No overlap: HSPC MUT unique
HENMT1	No overlap: HSPC MUT unique
SMARCB1	No overlap: HSPC MUT unique
PDCD7	No overlap: HSPC MUT unique
CUTC	No overlap: HSPC MUT unique
HEXIM1	No overlap: HSPC MUT unique
UBE2Z	No overlap: HSPC MUT unique
ATP6V0A1	No overlap: HSPC MUT unique
NR1H2	No overlap: HSPC MUT unique
NUB1	No overlap: HSPC MUT unique
P2RY8	No overlap: HSPC MUT unique
ATF7IP	No overlap: HSPC MUT unique
RPA3	No overlap: HSPC MUT unique
SMIM11	No overlap: HSPC MUT unique
CD151	No overlap: HSPC MUT unique
ADAM8	No overlap: HSPC MUT unique
POLR2A	No overlap: HSPC MUT unique
MPI	No overlap: HSPC MUT unique
GLIPR2	No overlap: HSPC MUT unique
DAXX	No overlap: HSPC MUT unique
NSA2	No overlap: HSPC MUT unique
GOT2	No overlap: HSPC MUT unique
RPA1	No overlap: HSPC MUT unique
SND1	No overlap: HSPC MUT unique
GMPR2	No overlap: HSPC MUT unique
CDKN2AIPNL	No overlap: HSPC MUT unique
CDK2AP1	No overlap: HSPC MUT unique
TIMP3	No overlap: HSPC MUT unique
RBM28	No overlap: HSPC MUT unique
IRF3	No overlap: HSPC MUT unique
MRPS6	No overlap: HSPC MUT unique
ARID5A	No overlap: HSPC MUT unique
TMEM106C	No overlap: HSPC MUT unique
AAMDC	No overlap: HSPC MUT unique
ERI3	No overlap: HSPC MUT unique
SNORD3A	No overlap: HSPC MUT unique
PRPS2	No overlap: HSPC MUT unique
RGL2	No overlap: HSPC MUT unique
FUBP3	No overlap: HSPC MUT unique
ARRDC1	No overlap: HSPC MUT unique
CHMP1A	No overlap: HSPC MUT unique
SRPR	No overlap: HSPC MUT unique
SRA1	No overlap: HSPC MUT unique
MBP	No overlap: HSPC MUT unique
EGLN2	No overlap: HSPC MUT unique
B3GNTL1	No overlap: HSPC MUT unique
SUGP2	No overlap: HSPC MUT unique
RNF13	No overlap: HSPC MUT unique
EIF2B4	No overlap: HSPC MUT unique
DPH7	No overlap: HSPC MUT unique
BRAT1	No overlap: HSPC MUT unique
PDE6D	No overlap: HSPC MUT unique
ZNF362	No overlap: HSPC MUT unique
LAMP1	No overlap: HSPC MUT unique
MCTP1	No overlap: HSPC MUT unique
RNF34	No overlap: HSPC MUT unique
TMUB2	No overlap: HSPC MUT unique
PRKAG1	No overlap: HSPC MUT unique
TMEM50B	No overlap: HSPC MUT unique
ERO1L	No overlap: HSPC MUT unique
MRPL45	No overlap: HSPC MUT unique
WDR46	No overlap: HSPC MUT unique
PPP1R11	No overlap: HSPC MUT unique
SNRPA	No overlap: HSPC MUT unique
ESYT1	No overlap: HSPC MUT unique
ACADS	No overlap: HSPC MUT unique
CETN2	No overlap: HSPC MUT unique
RRAS	No overlap: HSPC MUT unique
IGBP1	No overlap: HSPC MUT unique
IFT20	No overlap: HSPC MUT unique
MRPL24	No overlap: HSPC MUT unique
NPRL2	No overlap: HSPC MUT unique
TINF2	No overlap: HSPC MUT unique
MRPL46	No overlap: HSPC MUT unique
RIC8A	No overlap: HSPC MUT unique
HIST1H2BC	No overlap: HSPC MUT unique
SNORD3D	No overlap: HSPC MUT unique
ELAC2	No overlap: HSPC MUT unique
